■□■■■■■■■■■■■■
■□■■■■■□□□□□□□
■□□□□■■□■■■■■■
■□■■□■■□■■■■■■
■□■■□■■□□□□□□■
○□■■□□■□■■■■□■
■■■■■□■□■■■■□■
■□□□□□□□□□□□□■
■□■■■■■□■■■■□■
■□■■■■■□■■■■□■
■□■□□□□□■■■■□■
■□■□■■■■■■■■□■
■□■□■■■■■■■■□■
■□■□□□□□■■■■□■
■□■■■■■■■■■■□■
■□□□□□□■□□□□□●
■■■■■■■■■■■■■■